    A   B   C   D
  ┏━━━┳━━━┳━━━┳━━━┓
0 ┃← → ▲#   #▼ ▲#▼┃
  ┣╸ ╺╋╸ ╺┻╸ ╺╋╸ ╺┫
1 ┃↑ ↓         ↔ ↕┃
  ┣╸ ╺┫   ·   ┣╸ ╺┫
2 ┃↖ ↗         ↙ ↘┃
  ┣━░━╋━▒━┳━▓━╋━█━┫
3 ┃░░░░▒▒▒▒▓▓▓▓████
  ┗━━━┻━━━┻━━━┻━━━┛