╔━━━━━━━━━━━━━━━━━━━━━━━━━━━━━━━━━━━━━━━━━━━━━━━━━━━━━━━━━━━━━━━━━━━━━━━━━━━━╗
┃ ╲                                                                         ╱ ┃
┃   ╲                               ▓▓▓▓▓▓▓                               ╱   ┃
┃     ╲                            ▓▓▓╠═╣▓▓▓                            ╱     ┃
┃       ╲                         ▓▓▓▓╠═╣▓▓▓▓                         ╱       ┃
┃         ╲                      ▓▓▓▓▓╠═╣▓▓▓▓▓                      ╱         ┃
┃           ╲                     ▓▓▓▓╠═╣▓▓▓▓                     ╱           ┃
┃      ┃╲     ╲                    ▓▓▓╠═╣▓▓▓                    ╱             ┃
┃      ┃ ╲╲     ╲                   ▓▓╠═╣▓▓                   ╱               ┃
┃      ┃   ╲╲     ╲                   ╠═╣                   ╱                 ┃
┃      ┃     ╲╲     ╲                 ╠═╣                 ╱                   ┃
┃      ┃       ╲╲     ╲               ╠═╣               ╱                     ┃
┃      ┃_________╲╲     ╲_____________________________╱                       ┃
┃      ┃░░░░░░░░░░┃      ┃                           ┃                        ┃
┃      ┃░░░░░░░░░░┃      ┃                           ┃                        ┃
┃      ┃░░░░░░░░░░┃      ┃                           ┃                        ┃
┃      ┃░░░░░░░░░░┃      ┃                           ┃                        ┃
┃      ┃░░░░░░░░░░┃      ┃                           ┃                        ┃
┃      ┃░░░░░░░░░░┃      ┃                           ┃                        ┃
┃      ┃░░░░░░░░░░┃      ┃                           ┃                        ┃
┃      ┃░░░░░░░░░░┃      ┃                           ┃                        ┃
┃      ┃░░░░░░░░░░┃      ┃                           ┃                        ┃
┃      ┃░░░░░░░░░░┃      ┃                           ┃                        ┃
┃      ┃░░░░░░░░░░┃      ┃                           ┃                        ┃
┃      ┃░░░░░░░░░░┃      ┖───────────────────────────┚                        ┃
┃      ┃░░░░░░░░░░┃    ╱                               ╲                      ┃
┃      ┃░░░░░░░░░░┃  ╱                ╠═╣                ╲                    ┃
┃      ┃░░░░░░░░░░┃╱                ▓▓╠═╣▓▓                ╲                  ┃
┃      ┃▓▓▓▓▓▓▓▓▓╱                 ▓▓▓╠═╣▓▓▓                 ╲                ┃
┃      ┃▓▓▓▓▓▓▓╱                  ▓▓▓▓╠═╣▓▓▓▓                  ╲              ┃
┃      ┃▓▓▓▓▓╱                   ▓▓▓▓▓╠═╣▓▓▓▓▓                   ╲            ┃
┃      ┃▓▓▓╱                      ▓▓▓▓╠═╣▓▓▓▓                      ╲          ┃
┃      ┃▓╱                         ▓▓▓╠═╣▓▓▓                         ╲        ┃
┃      ╱                            ▓▓▓▓▓▓▓                            ╲      ┃
┃    ╱                                                                   ╲    ┃
╚━━━━━━━━━━━━━━━━━━━━━━━━━━━━━━━━━━━━━━━━━━━━━━━━━━━━━━━━━━━━━━━━━━━━━━━━━━━━━╝
