┏━━━┳━━━┳━━━┳━━━┳━━━┳━━━┳━━━┳━━━┳━━━┳━━━┳━━━┳━━━┳━━━┳━━━┳━━━┳━━━┓
┃   ┃   ┃   ┃   ┃   ┃   ┃   ┃   ┃   ┃   ┃   ┃   ┃   ┃   ┃   ┃   ┃
┣━━━╋━━━╋━━━╋━━━╋━━━╋━━━╋━━━╋━━━╋━━━╋━━━╋━━━╋━━━╋━━━╋━━━╋━━━╋━━━┫
┃   ┃   ┃   ┃   ┃   ┃   ┃   ┃   ┃   ┃   ┃   ┃   ┃   ┃   ┃   ┃   ┃
┣━━━╋━━━╋━━━╋━━━╋━━━╋━━━╋━━━╋━━━╋━━━╋━━━╋━━━╋━━━╋━━━╋━━━╋━━━╋━━━┫
┃   ┃   ┃   ┃   ┃   ┃   ┃   ┃   ┃   ┃   ┃   ┃   ┃   ┃   ┃   ┃   ┃
┣━━━╋━━━╋━━━╋━━━╋━━━╋━━━╋━━━╋━━━╋━━━╋━━━╋━━━╋━━━╋━━━╋━━━╋━━━╋━━━┫
┃   ┃   ┃   ┃   ┃   ┃   ┃   ┃   ┃   ┃   ┃   ┃   ┃   ┃   ┃   ┃   ┃
┣━━━╋━━━╋━━━╋━━━╋━━━╋━━━╋━━━╋━━━╋━━━╋━━━╋━━━╋━━━╋━━━╋━━━╋━━━╋━━━┫
┃   ┃   ┃   ┃   ┃   ┃   ┃   ┃   ┃   ┃   ┃   ┃   ┃   ┃   ┃   ┃   ┃
┣━━━╋━━━╋━━━╋━━━╋━━━╋━━━╋━━━╋━━━╋━━━╋━━━╋━━━╋━━━╋━━━╋━━━╋━━━╋━━━┫
┃   ┃   ┃   ┃   ┃   ┃   ┃   ┃   ┃   ┃   ┃   ┃   ┃   ┃   ┃   ┃   ┃
┣━━━╋━━━╋━━━╋━━━╋━━━╋━━━╋━━━╋━━━╋━━━╋━━━╋━━━╋━━━╋━━━╋━━━╋━━━╋━━━┫
┃   ┃   ┃   ┃   ┃   ┃   ┃   ┃   ┃   ┃   ┃   ┃   ┃   ┃   ┃   ┃   ┃
┣━━━╋━━━╋━━━╋━━━╋━━━╋━━━╋━━━╋━━━╋━━━╋━━━╋━━━╋━━━╋━━━╋━━━╋━━━╋━━━┫
┃   ┃   ┃   ┃   ┃   ┃   ┃   ┃   ┃   ┃   ┃   ┃   ┃   ┃   ┃   ┃   ┃
┗━━━┻━━━┻━━━┻━━━┻━━━┻━━━┻━━━┻━━━┻━━━┻━━━┻━━━┻━━━┻━━━┻━━━┻━━━┻━━━┛
