╺━━━┳━━━━━━━━━━━━━━━┓
    ┃               ┃
┏━━━┛   ·   ·   ·   ┃
┃                   ┃
┃   ·   ·   ·   ·   ┃
┃                   ┃
┃   ·   ·   ·   ·   ┃
┃                   ┃
┃   ·   ·   ·   ·   ┃
┃                   ┃
┗━━━━━━━━━━━━━━━━━━━┛
