┏━━━━━━━━━━━━━━━━━━━━━━━━━━━━━━━━━━━━━━━┓
┃        ░░░                            ┃
┃   ·   ·   ·   ·   ·   ·   ·   ·   ·   ┃
┃                                       ┃
┃   ·   ·   ·   ·   ·   ·   ·   ·   ·   ┃
┃                                       ┃
┃   ·   ·   ·   ·   ·   ·   ·   ·   ·   ┃
┃                                       ┃
┃   ·   ·   ·   ·   ·   ·   ·   ·   ·   ┃
┃▓▓▓                                 ▓▓▓┃
┃   ·   ·   ·   ·   ·   ·   ·   ·   ·   ┃
┃▓▓▓                     ░░░            ┃
┃   ·   ·   ·   ·   ·   ·   ·   ·   ·   ┃
┃                                ░░░    ┃
┗━━━━━━━━━━━━━━━━━━━━━━━━━━━━━━━━━━━━━━━┛
