┃                           ┃
┃   ┍━━━━━━━━━━━━━━━━━━━┑   ┃
┃   │ ╲               ╱ │   ┃
┃   │   ╲           ╱   │   ┃
┃   │     ╲ _____ ╱     │   ┃
┃   │      │     │      │   ┃
┃   │      │     │      │   ┃
┃   │      │_____│      │   ┃
┃   │     ╱       ╲     │   ┃
┃   │   ╱           ╲   │   ┃
┃   │ ╱               ╲ │   ┃
┖───┴───────────────────┴───┚