╔━━━━━━━━━━━━━━━━━━━━━━━━━━━━━━━━━━━━━━━━━━━━━━━━━━━━━━━━━━━━━━━━━━━━━━━━━━━━━╗
┃ ╲                                                                         ╱ ┃
┃   ╲                               ▓▓▓▓▓▓▓                               ╱   ┃
┃     ╲                            ▓▓▓╠═╣▓▓▓                            ╱     ┃
┃       ╲                         ▓▓▓▓╠═╣▓▓▓▓                         ╱       ┃
┃         ╲                      ▓▓▓▓▓╠═╣▓▓▓▓▓                      ╱         ┃
┃           ╲                     ▓▓▓▓╠═╣▓▓▓▓                     ╱           ┃
┃      ┃╲     ╲                    ▓▓▓╠═╣▓▓▓                    ╱     ╱┃      ┃
┃      ┃ ╲╲     ╲                   ▓▓╠═╣▓▓                   ╱     ╱╱ ┃      ┃
┃      ┃   ╲╲     ╲                   ╠═╣                   ╱     ╱╱   ┃      ┃
┃      ┃     ╲╲     ╲                 ╠═╣                 ╱     ╱╱     ┃      ┃
┃      ┃       ╲╲     ╲               ╠═╣               ╱     ╱╱       ┃      ┃
┃      ┃_________╲╲     ╲_____________________________╱     ╱╱_________┃      ┃
┃      ┃░░░░░░░░░░┃      ┃                           ┃      ┃░░░░░░░░░░┃      ┃
┃      ┃░░░░░░░░░░┃      ┃   ┍━━━━━━━━━━━━━━━━━━━┑   ┃      ┃░░░░░░░░░░┃      ┃
┃      ┃░░░░░░░░░░┃      ┃   │░░░\▒▒▒▒▒▒▒▒▒▒▒/░░░│   ┃      ┃░░░░░░░░░░┃      ┃
┃      ┃░░░░░░░░░░┃      ┃   │░░░░\▒▒▒▒▒▒▒▒▒/░░░░│   ┃      ┃░░░░░░░░░░┃      ┃
┃      ┃░░░░░░░░░░┃      ┃   │░░░░░\▒▒▒▒▒▒▒/░░░░░│   ┃      ┃░░░░░░░░░░┃      ┃
┃      ┃░░░░░░░░░░┃      ┃   │░░░░░░│▓▓▓▓▓│░░░░░░│   ┃      ┃░░░░░░░░░░┃      ┃
┃      ┃░░░░░░░░░░┃      ┃   │░░░░░░│▓▓▓▓▓│░░░░░░│   ┃      ┃░░░░░░░░░░┃      ┃
┃      ┃░░░░░░░░░░┃      ┃   │░░░░░░│▓▓▓▓▓│░░░░░░│   ┃      ┃░░░░░░░░░░┃      ┃
┃      ┃░░░░░░░░░░┃      ┃   │░░░░░/▒▒▒▒▒▒▒\░░░░░│   ┃      ┃░░░░░░░░░░┃      ┃
┃      ┃░░░░░░░░░░┃      ┃   │░░░░/▒▒▒▒▒▒▒▒▒\░░░░│   ┃      ┃░░░░░░░░░░┃      ┃
┃      ┃░░░░░░░░░░┃      ┃   │░░░/▒▒▒▒▒▒▒▒▒▒▒\░░░│   ┃      ┃░░░░░░░░░░┃      ┃
┃      ┃░░░░░░░░░░┃      ┖───┴───────────────────┴───┚      ┃░░░░░░░░░░┃      ┃
┃      ┃░░░░░░░░░░┃    ╱                               ╲    ┃░░░░░░░░░░┃      ┃
┃      ┃░░░░░░░░░░┃  ╱                ╠═╣                ╲  ┃░░░░░░░░░░┃      ┃
┃      ┃░░░░░░░░░░┃╱                ▓▓╠═╣▓▓                ╲┃░░░░░░░░░░┃      ┃
┃      ┃▓▓▓▓▓▓▓▓▓╱                 ▓▓▓╠═╣▓▓▓                 ╲▓▓▓▓▓▓▓▓▓┃      ┃
┃      ┃▓▓▓▓▓▓▓╱                  ▓▓▓▓╠═╣▓▓▓▓                  ╲▓▓▓▓▓▓▓┃      ┃
┃      ┃▓▓▓▓▓╱                   ▓▓▓▓▓╠═╣▓▓▓▓▓                   ╲▓▓▓▓▓┃      ┃
┃      ┃▓▓▓╱                      ▓▓▓▓╠═╣▓▓▓▓                      ╲▓▓▓┃      ┃
┃      ┃▓╱                         ▓▓▓╠═╣▓▓▓                         ╲▓┃      ┃
┃      ╱                            ▓▓▓▓▓▓▓                            ╲      ┃
┃    ╱                                                                   ╲    ┃
╚━━━━━━━━━━━━━━━━━━━━━━━━━━━━━━━━━━━━━━━━━━━━━━━━━━━━━━━━━━━━━━━━━━━━━━━━━━━━━╝