╔━━━━━━━━━━━━━━━━━━━━━━━━━━━━━━━━━━━━━━━━━━━━━━━━━━━━━━━━━━━━━━━━━━━━━━━━━━━━━╗
┃ ╲                                                                         ╱ ┃
┃   ╲                                                                     ╱   ┃
┃     ╲                                                                 ╱     ┃
┃       ╲                                                             ╱       ┃
┃         ╲                                                         ╱         ┃
┃           ╲                                                     ╱           ┃
┃             ╲                                                 ╱             ┃
┃               ╲                                             ╱               ┃
┃                 ╲                                         ╱                 ┃
┃                   ╲                                     ╱                   ┃
┃                     ╲                                 ╱                     ┃
┃                       ╲_____________________________╱                       ┃
┃                        ┃                           ┃                        ┃
┃                        ┃                           ┃                        ┃
┃                        ┃                           ┃                        ┃
┃                        ┃                           ┃                        ┃
┃                        ┃                           ┃                        ┃
┃                        ┃                           ┃                        ┃
┃                        ┃                           ┃                        ┃
┃                        ┃                           ┃                        ┃
┃                        ┃                           ┃                        ┃
┃                        ┃                           ┃                        ┃
┃                        ┃                           ┃                        ┃
┃                        ┖───────────────────────────┚                        ┃
┃                      ╱                               ╲                      ┃
┃                    ╱                                   ╲                    ┃
┃                  ╱                                       ╲                  ┃
┃                ╱                                           ╲                ┃
┃              ╱                                               ╲              ┃
┃            ╱                                                   ╲            ┃
┃          ╱                                                       ╲          ┃
┃        ╱                                                           ╲        ┃
┃      ╱                                                               ╲      ┃
┃    ╱                                                                   ╲    ┃
╚━━━━━━━━━━━━━━━━━━━━━━━━━━━━━━━━━━━━━━━━━━━━━━━━━━━━━━━━━━━━━━━━━━━━━━━━━━━━━╝