┃   ┍━━━━━━━━━━━━━━━━━━━┑   ┃
┃   │░░░\▒▒▒▒▒▒▒▒▒▒▒/░░░│   ┃
┃   │░░░░\▒▒▒▒▒▒▒▒▒/░░░░│   ┃
┃   │░░░░░\▒▒▒▒▒▒▒/░░░░░│   ┃
┃   │░░░░░░│▓▓▓▓▓│░░░░░░│   ┃
┃   │░░░░░░│▓▓▓▓▓│░░░░░░│   ┃
┃   │░░░░░░│▓▓▓▓▓│░░░░░░│   ┃
┃   │░░░░░/▒▒▒▒▒▒▒\░░░░░│   ┃
┃   │░░░░/▒▒▒▒▒▒▒▒▒\░░░░│   ┃
┃   │░░░/▒▒▒▒▒▒▒▒▒▒▒\░░░│   ┃
┖───┴───────────────────┴───┚