┃                           ┃
┃   ┍━━━━━━━━━━━━━━━━━━━┑   ┃
┃   │ ╲       H       ╱ │   ┃
┃   │   ╲     H     ╱   │   ┃
┃   │ │╲  ╲ _____ ╱  ╱│ │   ┃
┃   │ │__╲ │ ___ │ ╱__│ │   ┃
┃   │ │▒▒│ │ ▓▓▓ │ │▒▒│ │   ┃
┃   │ │▒▒│ │_▓▓▓_│ │▒▒│ │   ┃
┃   │ │▒▒│╱       ╲│▒▒│ │   ┃
┃   │ │▓╱     H     ╲▓│ │   ┃
┃   │ ╱       H       ╲ │   ┃
┖───┴───────────────────┴───┚