XXXXXXXXX
XXXXXXXXX
XXXXXXXXX
XXXXOXXXX
XXXOOOXXX
XXXXOXXXX
XXXXXXXXX
XXXXXXXXX
XXXXXXXXX