XXXXXXXXX
XXXOOOXXX
XXXOOOXXX
XXXXOXXXX
XOOXOXOOX
XXOXOXOXX
XXOOOOOXX
XXXXOXXXX
XXXXXXXXX