OOOOOOOOO
OOOOOOOOO
OOOOOOOOO
OOOOOOOOO
OOXOOOXOO
XOXOXOXOX
OOOOOOOOO
OOOOOOOOO
OOOOOOOOO