XXXXXXXXX
XXXXXXXXX
XXXXXXXXX
XOOOOOOOX
OXOOOOOXO
XOOOOOOOX
XXXXXXXXX
XXXXXXXXX
XXXXXXXXX