XXXOXOXXX
XXXOOOXXX
XXXOOOXXX
OOOXXXOOO
XOOXXXOOX
OOOXXXOOO
XXXOOOXXX
XXXOOOXXX
XXXOXOXXX