XXXOXOXXX
XXOOOOOXX
XOOOOOOOX
OOOOXOOOO
XOOXXXOOX
OOOOXOOOO
XOOOOOOOX
XXOOOOOXX
XXXOXOXXX