OXXXXXXXO
XOXXXXXOX
XXOXXXOXX
XXXOOOXXX
XXXOOOXXX
XXXOOOXXX
XXOXXXOXX
XOXXXXXOX
OXXXXXXXO