XXXXXXXXX
XXOOOOOXX
XOXOOOXOX
XOOXOXOOX
XOOOOOOOX
XOOXOXOOX
XOXOOOXOX
XXOOOOOXX
XXXXXXXXX