XXXXXXXXX
XXXXOXXXX
XXOOOOOXX
XXOXOXOXX
XOOOOOOOX
XXOXOXOXX
XXOOOOOXX
XXXXOXXXX
XXXXXXXXX