XXXXXXXXX
XXXXOXXXX
XXOXOXOXX
XXXOOOXXX
XOOOOOOOX
XXXOOOXXX
XXOXOXOXX
XXXXOXXXX
XXXXXXXXX