OXXXOXXXO
OOXOOOXOO
OXXXOXXXO
XXXXOXXXX
XXXOOOXXX
XXXXOXXXX
OXXXOXXXO
OOXOOOXOO
OXXXOXXXO