XXXXXXXXX
XXXXXXXXX
XXXXXXXXX
XXXXXXXXX
XXOXXXXXX
XOOOXXXXX
XXOXXXXXX
XXXXXXXXX
XXXXXXXXX